7 7
6 6 6 6 6 6 0 
6 4 2 2 4 6 6
6 4 2 6 3 4 6
6 4 5 3 4 4 6
6 4 4 4 3 4 6
6 6 6 6 4 4 6
0 0 0 6 6 6 6