7 8
0 0 6 6 6 6 6
0 0 6 4 4 4 6
0 0 6 5 6 1 6
6 6 6 3 4 4 6
6 2 4 3 4 4 6
6 4 6 4 6 2 6
6 4 4 4 4 4 6
6 6 6 6 6 6 6