8 8
6 6 6 6 6 0 0 0
6 2 2 2 6 0 0 0
6 6 4 4 6 6 6 0
6 4 4 3 3 5 6 6
6 4 4 4 3 4 4 6
6 6 6 6 4 4 4 6
0 0 0 6 4 4 4 6
0 0 0 6 6 6 6 6