8 8
0 6 6 6 6 6 6 6 
0 6 4 4 4 4 4 6
6 6 4 6 4 4 4 6
6 2 1 6 4 4 6 6
6 2 4 6 4 6 6 6
6 5 3 3 4 4 4 6
6 4 4 6 4 4 4 6
6 6 6 6 6 6 6 6