7 7
6 6 6 6 6 6 6
6 2 6 4 4 4 6
6 2 4 4 4 2 6
6 4 4 4 3 4 6
6 6 6 6 3 3 6
0 0 0 6 5 4 6
0 0 0 6 6 6 6