12 7
0 6 6 6 6 0 6 6 6 6 6 6
0 6 4 4 6 6 6 4 4 4 4 6
6 6 4 4 4 4 4 4 4 4 4 6
6 4 1 3 6 6 6 6 4 4 6 6
6 4 2 5 6 0 6 4 4 4 6 0
6 6 6 6 6 0 6 4 4 4 6 0
0 0 0 0 0 0 6 6 6 6 6 0
