7 7
0 6 6 6 6 6 6 
0 6 4 2 2 2 6
0 6 3 6 4 4 6
6 6 4 4 5 4 6
6 4 3 3 4 4 6
6 4 4 4 4 6 6
6 6 6 6 6 6 0