7 7
0 0 6 6 6 6 6
0 0 6 4 2 4 6
6 6 6 3 2 4 6
6 4 4 4 2 4 6
6 4 3 3 4 4 6
6 6 4 5 6 6 6
0 6 6 6 6 0 0