7 7
6 6 6 6 6 0 0
6 4 4 4 6 6 6
6 2 4 2 3 5 6
6 2 1 1 3 6 6
6 6 4 4 3 4 6
0 6 4 4 4 4 6
0 6 6 6 6 6 6