7 8
6 6 6 6 6 6 6
6 4 4 4 4 4 6
6 2 6 4 6 4 6
6 4 3 3 2 4 6
6 2 4 4 6 6 6
6 4 6 3 6 0 0
6 4 4 5 6 0 0
6 6 6 6 6 0 0