7 9
0 6 6 6 0 0 0 
0 6 7 6 0 0 0
0 6 1 6 6 6 6
6 6 4 4 4 4 6
6 4 4 3 6 4 6
6 4 6 4 4 4 6
6 4 6 6 6 4 6
6 4 4 4 4 4 6
6 6 6 6 6 6 6