6 6
0 6 6 6 6 6
0 6 5 2 2 6
6 6 3 1 3 6
6 4 4 4 4 6
6 4 4 4 4 6
6 6 6 6 6 6