7 7
0 6 6 6 6 6 6
0 6 4 4 6 2 6
0 6 5 4 6 2 6
6 6 3 4 4 4 6
6 4 4 3 4 4 6
6 4 4 4 6 6 6
6 6 6 6 6 0 0