7 7
6 6 6 6 6 6 6
6 2 3 4 4 4 6
6 4 6 3 2 4 6
6 4 4 4 3 6 6
6 5 4 4 2 6 0
6 6 4 4 6 6 0
0 6 6 6 6 0 0