8 7
6 6 6 6 6 6 0 0
6 2 2 4 4 6 0 0
6 2 4 4 4 6 6 6
6 6 6 4 3 4 4 6
0 0 6 3 3 4 4 6
0 0 6 5 4 6 6 6
0 0 6 6 6 6 0 0