6 8
6 6 6 6 0 0 
6 4 4 6 0 0 
6 4 4 6 6 6
6 4 4 3 4 6
6 4 4 1 2 6
6 5 1 4 4 6
6 4 4 6 6 6
6 6 6 6 0 0