7 7
6 6 6 6 6 6 6
6 4 4 2 4 4 6
6 4 2 2 3 4 6
6 6 4 3 4 4 6
0 6 6 6 3 4 6
0 0 0 6 5 6 6
0 0 0 6 6 6 0