7 7
0 0 6 6 6 6 6
6 6 6 4 2 4 6
6 4 3 3 1 4 6
6 4 3 4 2 4 6
6 4 5 3 1 4 6
6 4 3 2 2 2 6
6 6 6 6 6 6 6