6 7
6 6 6 6 6 0
6 2 2 7 6 0
6 4 3 3 6 6
6 6 3 4 4 6
6 4 4 4 4 6
6 4 4 4 4 6
6 6 6 6 6 6