10 9
0 6 6 6 0 0 0 0 0 0
0 6 2 6 6 6 6 6 6 6
0 6 2 6 4 4 4 4 4 6
6 6 7 4 4 6 6 6 4 6
6 4 1 4 3 6 6 6 4 6
6 4 6 4 4 3 4 4 4 6
6 4 4 4 3 6 6 6 6 6
6 4 4 4 4 6 0 0 0 0
6 6 6 6 6 6 0 0 0 0 