7 7
6 6 6 6 6 6 6
6 4 4 4 2 2 6
6 2 1 1 2 3 6
6 6 5 3 3 4 6
0 6 3 4 4 4 6
0 6 4 4 4 4 6
0 6 6 6 6 6 6