7 7
0 0 0 0 6 6 6 
6 6 6 6 6 2 6
6 4 4 6 6 2 6
6 4 4 4 3 4 6
6 4 4 3 6 4 6
6 6 6 4 4 5 6
0 0 6 6 6 6 6 