7 7
6 6 6 6 6 6 6
6 2 4 4 4 4 6
6 1 6 4 4 4 6
6 2 3 4 3 4 6
6 2 1 3 3 4 6
6 2 6 5 4 4 6
6 6 6 6 6 6 6