7 7
6 6 6 6 6 6 6
6 2 2 1 2 2 6
6 4 6 3 1 2 6
6 4 4 4 3 4 6
6 4 4 3 3 3 6
6 5 4 4 4 4 6
6 6 6 6 6 6 6