7 6
0 0 0 6 6 6 6
6 6 6 6 5 2 6
6 4 4 4 3 1 6
6 4 4 4 6 4 6
6 6 6 4 4 4 6
0 0 6 6 6 6 6