7 7
0 0 6 6 6 6 6
6 6 6 4 4 2 6
6 5 3 2 2 1 6
6 6 3 3 1 4 6
6 4 4 4 4 4 6
6 4 4 4 4 6 6
6 6 6 6 6 6 0