19 16
6 6 6 6 0 0 0 0 0 0 0 0 0 0 0 0 0 0 0
6 4 4 6 6 6 6 6 6 6 6 6 6 6 6 6 6 0 0
6 4 4 6 4 4 4 2 2 6 2 2 2 2 2 2 6 0 0
6 4 4 6 4 6 4 6 6 6 6 6 4 2 2 2 6 0 0
6 6 3 6 4 4 4 4 2 2 2 2 2 2 2 2 6 0 0
6 4 4 4 6 6 3 6 6 6 6 6 6 4 4 6 6 6 6
6 4 3 4 6 4 4 4 4 4 6 6 6 6 6 6 5 4 6
6 6 3 4 6 4 3 4 4 4 6 6 6 6 6 6 4 4 6
6 4 4 3 4 6 3 3 3 6 6 4 4 4 4 4 4 4 6
6 4 4 4 4 4 4 6 4 4 4 4 6 3 6 3 6 6 6
6 4 6 6 6 6 4 6 3 3 3 3 3 4 4 4 4 6 0
6 4 6 4 4 4 4 3 4 4 4 4 4 6 4 4 4 6 0
6 4 6 4 4 4 6 6 4 4 4 4 4 4 4 4 6 6 6
6 4 6 6 6 6 6 6 3 6 6 6 6 6 6 4 3 4 6
6 4 4 4 4 4 4 4 4 6 0 0 0 0 6 4 4 4 6
6 6 6 6 6 6 6 6 6 6 0 0 0 0 6 6 6 6 6