12 11
6 6 6 6 6 6 0 0 6 6 6 0
6 2 2 4 4 6 0 6 6 5 6 6
6 2 2 4 4 6 6 6 4 4 4 6
6 2 2 4 4 4 4 4 3 3 4 6
6 2 2 4 4 6 4 6 4 3 4 6
6 2 2 6 6 6 4 6 4 3 4 6
6 6 6 6 4 3 4 6 3 4 4 6
0 0 0 6 4 4 3 6 4 3 4 6
0 0 0 6 4 3 4 4 3 4 4 6
0 0 0 6 4 4 6 6 4 4 4 6
0 0 0 6 6 6 6 6 6 6 6 6