8 9
0 0 6 6 6 6 6 0
6 6 6 4 4 4 6 0
6 2 5 3 4 4 6 0
6 6 6 4 3 2 6 0
6 2 6 6 3 4 6 0
6 4 6 4 2 4 6 6
6 3 4 1 3 3 2 6
6 4 4 4 2 4 4 6
6 6 6 6 6 6 6 6
